####################################
##     ###       ### ##            #
## ###   ### ### ###    ########## #
#  #   #     ### ################# #
# ##########  ## ##                #
#         ###  # ## ######### ######
#### ######### #### #       # #    #
#### ###  #### #### # ##### # # ## #
## #  ###    #   ## # #   # # # ## #
## ##   #### ### ## #   # # # # g# #
#  #  #     s###### ##### # # #### #
# ##### #     ## ##       # #      #
#       #         ######### # ## ###
#########                   ####   #
####################################